#include <stdio.h>
#include <windows.h>
#define L 20
#define C 29
int main()
{
    int i,j;
	int mapa[L][C] = {

    {201, 205, 205, 205, 205, 205, 205, 205, 205, 205, 205, 205, 205, 205, 205, 205, 205, 205, 205, 205, 205, 205, 205, 205, 205, 205, 205, 205, 187},
    {186, 0, 0, 0, 0, 0, 0, 0, 0, 0, 0, 0, 205, 205, 205, 205, 205, 0, 0, 0, 0, 0, 0, 0, 0, 0, 0, 0, 186},
    {186, 0, 205, 205, 205, 0, 205, 205, 205, 205, 205, 0, 205, 205, 205, 205, 205, 0, 205, 205, 205, 205, 205, 0, 205, 205, 205, 0, 186},
    {186, 0, 205, 205, 205, 0, 205, 205, 205, 205, 205, 0, 205, 205, 205, 205, 205, 0, 205, 205, 205, 205, 205, 0, 205, 205, 205, 0, 186},
    {186, 0, 205, 205, 205, 0, 0, 0, 0, 0, 0, 0, 0, 0, 0, 0, 0, 0, 0, 0, 0, 0, 0, 0, 205, 205, 205, 0, 186},
    {186, 0, 205, 205, 205, 0, 205, 205, 205, 205, 205, 205, 205, 205, 205, 205, 205, 205, 205, 205, 205, 205, 205, 0, 205, 205, 205, 0, 186},
    {186, 0, 205, 205, 205, 0, 205, 205, 205, 205, 205, 205, 205, 205, 205, 205, 205, 205, 205, 205, 205, 205, 205, 0, 205, 205, 205, 0, 186},
    {186, 0, 205, 205, 205, 0, 205, 205, 205, 205, 205, 205, 205, 205, 205, 205, 205, 205, 205, 205, 205, 205, 205, 0, 205, 205, 205, 0, 186},
    {186, 0, 205, 205, 205, 0, 0, 0, 0, 0, 0, 0, 0, 0, 0, 0, 0, 0, 0, 0, 0, 0, 0, 0, 205, 205, 205, 0, 186},
    {186, 0, 0, 0, 0, 0, 205, 205, 205, 205, 0, 0, 0, 0, 0, 0, 0, 0, 0, 205, 205, 205, 205, 0, 0, 0, 0, 0, 186},
    {186, 0, 205, 205, 205, 0, 205, 205, 205, 205, 205, 205, 205, 205, 205, 205, 205, 205, 205, 205, 205, 205, 205, 0, 205, 205, 205, 0, 186},
    {186, 0, 205, 205, 205, 0, 205, 205, 205, 205, 205, 205, 205, 205, 205, 205, 205, 205, 205, 205, 205, 205, 205, 0, 205, 205, 205, 0, 186},
    {186, 0, 205, 205, 205, 0, 205, 205, 205, 205, 205, 205, 205, 205, 205, 205, 205, 205, 205, 205, 205, 205, 205, 0, 205, 205, 205, 0, 186},
    {186, 0, 205, 205, 205, 0, 205, 205, 205, 205, 205, 205, 205, 205, 205, 205, 205, 205, 205, 205, 205, 205, 205, 0, 205, 205, 205, 0, 186},
    {186, 0, 205, 205, 205, 0, 205, 205, 205, 205, 205, 205, 205, 205, 205, 205, 205, 205, 205, 205, 205, 205, 205, 0, 205, 205, 205, 0, 186},
    {186, 0, 205, 205, 205, 0, 0, 0, 0, 0, 0, 0, 0, 0, 0, 0, 0, 0, 0, 0, 0, 0, 0, 0, 205, 205, 205, 0, 186},
    {186, 0, 205, 205, 205, 0, 205, 205, 205, 205, 0, 205, 205, 205, 205, 205, 205, 205, 205, 0, 205, 205, 205, 0, 205, 205, 205, 0, 186},
    {186, 0, 205, 205, 205, 0, 205, 205, 205, 205, 0, 205, 205, 205, 205, 205, 205, 205, 205, 0, 205, 205, 205, 0, 205, 205, 205, 0, 186},
    {186, 0, 0, 0, 0, 0, 0, 0, 0, 0, 0, 205, 205, 205, 205, 205, 205, 205, 205, 0, 0, 0, 0, 0, 0, 0, 0, 0, 186},
    {200, 205, 205, 205, 205, 205, 205, 205, 205, 205, 205, 205, 205, 205, 205, 205, 205, 205, 205, 205, 205, 205, 205, 205, 205, 205, 205, 205, 188}};
    
    for (i=0; i<L;i++){
		for(j=0; j<C; j++){
			printf("%c", mapa[i][j]);
		}
		printf("\n");
	}
	return 0;
}
